
NO ./img/N.xpm
SO ./img/S.xpm
WE ./img/E.xpm
EA ./img/W.xpm


F 135,206,235
C 34,139,34

1111
100N111111111111
100000001111111
1000000111111
10000000111111
111111111
