
NO ./img/N.xpm
SO ./img/S.xpm
WE ./img/E.xpm
EA ./img/W.xpm


F 135,206,235
C 34,139,34

11111111111111111111111111111111111111111111111111
10000000000000000000000000000000000000000000000001
10101010101110111010111011101110101110111010101001
10000000000000000000000000000000000000000000000001
10101110101110111011101110101110111011101110101001
10000000000000000000000000000000000000000000000001
10101110111010101110111011101110111010101110101001
10000000000000000000000000000000000000000000000001
10101010101110111010111011101110101110111010101001
10000000000000000000000000000000000000000000000001
10101110101110111011101110101110111011101110101001
10000000000000000000000000000000000000000000000001
10101110111010101110111011101110111010101110101001
10000000000000000000000000000000000000000000000001
10101010101110111010111011101110101110111010101001
10000000000000000000000000000000000000000000000001
10101110101110111011101110101110111011101110101001
10000000000000000000000000000000000000000000000001
10101110111010101110111011101110111010101110101001
11111111111111111111111111111111111111111111111111

