NO ./img/N.xpm
SO ./img/S.xpm
WE ./img/E.xpm
EA ./img/W.xpm


F 135,206,235
C 34,139,34

11111111111111111111111111111111111111111111111111
10000000001000000000000000000000000000000000000001
10111111001011111010101111101011101110111010111001
10000001000000001010000000100000000000000000001001
10111001011111001010101110101111101111101011101001
10001001000001000000001000000000001000000000001001
10101001111001011111001011101110101110111011101001
11111111111111111111111111111111111111111111111111