NO ./img/N.xpm
SO ./img/S.xpm
WE ./img/E.xpm
EA ./img/W.xpm


F 135,206,235
C 34,139,34

11111111111111111111111111111111111111111111111111
10000000N00000000000000001
101010101010101010101010101001
100000000000000000000000000001
101010101010101010101010101001
100000000000000000000000000001
101010101010101010101010101011
11111111111111111111111111111111111111111111111111
