NO ./img/N.xpm
SO ./img/S.xpm
WE ./img/E.xpm
EA ./img/W.xpm


F 135,206,235
C 34,139,34

1111111111111111111111111111111111111111111111111111111111
100000000000000000000000000000000000000000000000000000001
1011111111101111111101111111110111111111011111001000000001
1000000000100000000010000000001000000000100000100000000001
1011111010101111101010111110101011111010101110100000000001
1000001010100000101010000010101000001010100000100000000001
1011101010111010101010111010101011101010111011100000000001
1000101010000010101000001010101000101010000000100000000001
1010101011111010101011101010101010101011111110100000000001
1000100000001010001000001010001000000000000010100000000001
1010111110101011101010101010101011111011101010100000000001
10000000101000000010100010100010000000101000101000000000001
10111110101110111010111010101110111010101110101000000000001
10000010100000001010000N10100000001000100000101000000000001
1111111111111111111111111111111111111111111111111111111111